8 105
0  0   0  0   0  0   0  0  0  0   0  0  0  0   0  0  0  0  0  0  0  0   0  0  0  0  0  0  0  0  0  0  0  0  0  0  0  0  0  0  0  0  0  0  0  0  0  0   0  0  0  0  0  0   0  0  0  0  0  0   0   0  0  0  0  0  0  0  0  0  0  0  0  0  0   0  0  0  0  0  0  0  0  0  0  0  0  0  0  0  0  0  0  0  0  0  0  0  0  0   0   0  0  0  0
0  0   0  0   0  0   0  0  0  0   0  0  0  0   0  0  0  0  0  0  0  0   0  0  0  0  0  0  0  0  0  0  0  0  0  0  0  0  0  0  0  0  0  0  0  0  0  0   0  0  0  0  0  0   0  0  0  0  0  0   0   0  0  0  0  0  0  0  0  0  0  0  0  0  0   0  0  0  0  0  0  0  0  0  0  0  0  0  0  0  0  0  0  0  0  0  0  0  0  0   0   0  0  0  0 
0  0   0  0   0  0   0  0  0  0   0  0  0  0   0  0  0  0  0  0  0  0   0  0  0  0  0  0  0  0  0  0  0  0  0  0  0  0  0  0  0  0  0  6  6  6  6  6   6  6  6  6  6  6   6  6  6  6  6  0   0   0  0  0  6  6  6  6  6  0  0  0  0  0  0   0  0  0  0  0  0  0  6  6  0  0  0  0  0  0  0  0  0  0  0  0  0  0  0  0   0   0  0  0  0
0  106 6  6   6  6   6  6  6  6   6  6  6  6   6  6  6  6  6  6  6  6   6  6  0  0  0  0  6  6  6  6  6  0  0  0  0  6  6  6  6  6  6  5  5  5  5  5   5  5  5  5  5  5   5  5  5  5  5  6   6   6  6  6  5  5  5  5  5  0  6  6  0  0  206 6  0  0  0  0  0  6  5  5  0  6  6  0  0  0  0  0  0  0  0  0  0  0  6  6   6   6  0  0  0
0  5   5  5   5  205 5  5  5  5   5  5  5  205 5  5  5  5  5  5  305  5   5  5  3  1  1  2  5  5  5  5  5  3  1  1  2  5  5  5  5  5  5  5  5  4  4  4   4  4  4  4  4  204 4  4  4  4  5  5   5   5  5  5  5  4  4  4  4  6  5  5  0  6  5   5  0  6  6  0  0  5  5  4  0  5  5  6  6  6  6  0  0  0  0  0  6  6  5  5   305   5  6  0  6
7  4   4  4   4  5   5  5  4  4   4  4  4  5   5  4  4  4  4  4  4  204 4  4  7  7  7  7  4  4  4  4  4  7  7  7  7  4  4  4  4  4  4  4  4  4  4  204 4  5  5  5  5   5  5  5  4  4  4  4   204 4  4  4  4  4  4  5  5  5  4  4  0  5  5   4  0  5  5  6  6  4  4  5  0  4  5  5  5  5  5  0  0  6  6  0  5  5  4   4  204 4  5  6  5 
7  10  10 10 11  4   4  4  5  204 4  5  11 4   4  10 10 11 4  4  5  5   5  10 7  7  7  7  10 10 10 10 10 7  7  7  7  10 11 4  4  4  4  4  4  4  4  5   5  4  4  4  4  4   4  4  4  4  4  4   5   5  4  5  5  4  5  4  4  4  4  4  0  4  4   4  0  4  5  5  5  4  4  4  0  4  4  4  4  4  4  6  0  5  5  0  4  4  4  5   5   5  4  5  4
7  7   7  7  7   8   8  8  8  9   9  8  7  8   8  7  7  7  8  9  9  8   8  7  7  7  7  7  7  7  7  7  7  7  7  7  7  7  7  10 10 10 10 10 9  9  9  10  10 10 10 10 10 10  409  9  9  9  9  9   4   4  4  4  4  4  4  4  4  4  4  4  0  4  4   4  0  5  4  4  4  4  5  4  0  4  4  4  4  5  5  5  0  4  4  0  4  4  5  5   5   5  5  5  5